id,yes:count,no:count,count,yes,party,no,state,name
1,0,7,7,0,R,1,AL,Other/No Answer
2,125,104,229,23,R,15,AL,Marco Rubio
3,38,14,52,7,R,2,AL,John Kasich
4,5,7,12,1,R,1,AL,Uncommitted
5,120,146,266,22,R,21,AL,Ted Cruz
6,65,62,127,12,R,9,AL,Ben Carson
7,5,0,5,1,R,0,AL,Jeb Bush
8,190,353,543,35,R,51,AL,Donald Trump
9,544,693,1237,44,R,56,AL,total
10,4,4,8,1,D,1,AL,Other/No Answer
11,335,335,670,76,D,79,AL,Hillary Clinton
12,4,13,17,1,D,3,AL,Uncommitted
13,97,72,169,22,D,17,AL,Bernie Sanders
14,441,424,865,51,D,49,AL,total
15,6,15,21,1,R,2,AR,Other/No Answer
16,193,160,353,31,R,21,AR,Marco Rubio
17,37,15,52,6,R,2,AR,John Kasich
18,174,236,410,28,R,31,AR,Ted Cruz
19,31,30,61,5,R,4,AR,Ben Carson
20,6,8,14,1,R,1,AR,Jeb Bush
21,174,296,470,28,R,39,AR,Donald Trump
22,622,760,1382,45,R,55,AR,total
23,8,11,19,2,D,2,AR,Other/No Answer
24,290,360,650,70,D,68,AR,Hillary Clinton
25,116,159,275,28,D,30,AR,Bernie Sanders
26,415,529,944,44,D,56,AR,total
27,30,18,48,3,R,2,FL,Other/No Answer
28,283,233,516,28,R,26,FL,Marco Rubio
29,91,45,136,9,R,5,FL,John Kasich
30,182,134,316,18,R,15,FL,Ted Cruz
31,0,9,9,0,R,1,FL,Ben Carson
32,425,457,882,42,R,51,FL,Donald Trump
33,1011,896,1907,53,R,47,FL,total
34,8,26,34,1,D,3,FL,Other/No Answer
35,509,552,1061,64,D,64,FL,Hillary Clinton
36,279,285,564,35,D,33,FL,Bernie Sanders
37,796,863,1659,48,D,52,FL,total
38,262,160,422,29,R,20,GA,Marco Rubio
39,54,40,94,6,R,5,GA,John Kasich
40,217,176,393,24,R,22,GA,Ted Cruz
41,54,48,102,6,R,6,GA,Ben Carson
42,9,8,17,1,R,1,GA,Jeb Bush
43,307,368,675,34,R,46,GA,Donald Trump
44,903,801,1704,53,R,47,GA,total
45,572,501,1073,71,D,73,GA,Hillary Clinton
46,233,185,418,29,D,27,GA,Bernie Sanders
47,805,686,1491,54,D,46,GA,total
48,19,0,19,3,R,0,IL,Other/No Answer
49,63,48,111,10,R,8,IL,Marco Rubio
50,157,85,242,25,R,14,IL,John Kasich
51,189,187,376,30,R,31,IL,Ted Cruz
52,6,6,12,1,R,1,IL,Ben Carson
53,195,278,473,31,R,46,IL,Donald Trump
54,629,604,1233,51,R,49,IL,total
55,8,7,15,1,D,1,IL,Other/No Answer
56,395,379,774,49,D,53,IL,Hillary Clinton
57,403,329,732,50,D,46,IL,Bernie Sanders
58,806,715,1521,53,D,47,IL,total
59,5,10,15,1,R,3,MA,Other/No Answer
60,96,45,141,20,R,14,MA,Marco Rubio
61,5,0,5,1,R,0,MA,No Preference
62,115,32,147,24,R,10,MA,John Kasich
63,48,26,74,10,R,8,MA,Ted Cruz
64,14,6,20,3,R,2,MA,Ben Carson
65,5,3,8,1,R,1,MA,Jeb Bush
66,192,198,390,40,R,62,MA,Donald Trump
67,481,320,801,60,R,40,MA,total
68,509,190,699,54,D,41,MA,Hillary Clinton
69,9,0,9,1,D,0,MA,No Preference
70,424,274,698,45,D,59,MA,Bernie Sanders
71,942,464,1406,67,D,33,MA,total
72,0,7,7,0,R,1,MI,Other/No Answer
73,88,43,131,14,R,6,MI,Marco Rubio
74,189,135,324,30,R,19,MI,John Kasich
75,13,7,20,2,R,1,MI,Uncommitted
76,158,178,336,25,R,25,MI,Ted Cruz
77,13,14,27,2,R,2,MI,Ben Carson
78,170,327,497,27,R,46,MI,Donald Trump
79,630,711,1341,47,R,53,MI,total
80,353,424,777,48,D,49,MI,Hillary Clinton
81,22,9,31,3,D,1,MI,Uncommitted
82,361,432,793,49,D,50,MI,Bernie Sanders
83,736,865,1601,46,D,54,MI,total
84,6,7,13,1,R,1,MS,Other/No Answer
85,40,29,69,7,R,4,MS,Marco Rubio
86,56,43,99,10,R,6,MS,John Kasich
87,192,281,473,34,R,39,MS,Ted Cruz
88,11,7,18,2,R,1,MS,Ben Carson
89,260,353,613,46,R,49,MS,Donald Trump
90,565,720,1285,44,R,56,MS,total
91,4,0,4,1,D,0,MS,Other/No Answer
92,348,521,869,78,D,88,MS,Hillary Clinton
93,94,71,165,21,D,12,MS,Bernie Sanders
94,446,592,1038,43,D,57,MS,total
95,6,0,6,1,R,0,MO,Other/No Answer
96,50,29,79,8,R,4,MO,Marco Rubio
97,100,44,144,16,R,6,MO,John Kasich
98,0,7,7,0,R,1,MO,Uncommitted
99,263,302,565,42,R,41,MO,Ted Cruz
100,6,7,13,1,R,1,MO,Ben Carson
101,201,346,547,32,R,47,MO,Donald Trump
102,627,736,1363,46,R,54,MO,total
103,291,286,577,48,D,51,MO,Hillary Clinton
104,0,6,6,0,D,1,MO,Uncommitted
105,316,269,585,52,D,48,MO,Bernie Sanders
106,607,561,1168,52,D,48,MO,total
107,11,0,11,1,R,0,NH,Other/No Answer
108,0,0,0,0,R,0,NH,Mike Huckabee
109,205,115,320,19,R,12,NH,John Kasich
110,129,86,215,12,R,9,NH,Jeb Bush
111,22,29,51,2,R,3,NH,Ben Carson
112,11,10,21,1,R,1,NH,Rand Paul
113,86,67,153,8,R,7,NH,Chris Christie
114,129,96,225,12,R,10,NH,Marco Rubio
115,119,124,243,11,R,13,NH,Ted Cruz
116,0,0,0,0,R,0,NH,Rick Santorum
117,43,29,72,4,R,3,NH,Carly Fiorina
118,324,402,726,30,R,42,NH,Donald Trump
119,1079,957,2036,53,R,47,NH,total
120,13,9,22,1,D,1,NH,Other/No Answer
121,573,276,849,43,D,31,NH,Hillary Clinton
122,0,9,9,0,D,1,NH,Martin O'Malley
123,746,596,1342,56,D,67,NH,Bernie Sanders
124,1333,889,2222,60,D,40,NH,total
125,156,89,245,32,R,19,NY,John Kasich
126,264,305,569,54,R,65,NY,Donald Trump
127,68,75,143,14,R,16,NY,Ted Cruz
128,488,469,957,51,R,49,NY,total
129,452,339,791,56,D,58,NY,Hillary Clinton
130,355,245,600,44,D,42,NY,Bernie Sanders
131,807,584,1391,58,D,42,NY,total
132,9,0,9,1,R,0,NC,Other/No Answer
133,73,53,126,8,R,6,NC,Marco Rubio
134,9,9,18,1,R,1,NC,No Preference
135,165,71,236,18,R,8,NC,John Kasich
136,349,335,684,38,R,38,NC,Ted Cruz
137,9,9,18,1,R,1,NC,Ben Carson
138,303,406,709,33,R,46,NC,Donald Trump
139,918,882,1800,51,R,49,NC,total
140,11,0,11,1,D,0,NC,Other/No Answer
141,574,455,1029,53,D,58,NC,Hillary Clinton
142,32,16,48,3,D,2,NC,No Preference
143,466,314,780,43,D,40,NC,Bernie Sanders
144,1083,784,1867,58,D,42,NC,total
145,12,0,12,1,R,0,OH,Other/No Answer
146,25,45,70,2,R,4,OH,Marco Rubio
147,676,431,1107,55,R,38,OH,John Kasich
148,147,159,306,12,R,14,OH,Ted Cruz
149,12,11,23,1,R,1,OH,Ben Carson
150,356,488,844,29,R,43,OH,Donald Trump
151,1229,1134,2363,52,R,48,OH,total
152,9,9,18,1,D,1,OH,Other/No Answer
153,492,486,978,57,D,54,OH,Hillary Clinton
154,363,405,768,42,D,45,OH,Bernie Sanders
155,864,900,1764,49,D,51,OH,total
156,9,5,14,2,R,1,OK,Other/No Answer
157,152,96,248,33,R,20,OK,Marco Rubio
158,18,14,32,4,R,3,OK,John Kasich
159,143,172,315,31,R,36,OK,Ted Cruz
160,28,33,61,6,R,7,OK,Ben Carson
161,0,0,0,0,R,0,OK,Jeb Bush
162,110,158,268,24,R,33,OK,Donald Trump
163,460,478,938,49,R,51,OK,total
164,20,38,58,5,D,9,OK,Other/No Answer
165,181,151,332,45,D,36,OK,Hillary Clinton
166,201,230,431,50,D,55,OK,Bernie Sanders
167,402,419,821,49,D,51,OK,total
168,11,9,20,1,R,1,SC,Other/No Answer
169,298,160,458,27,R,17,SC,Marco Rubio
170,110,38,148,10,R,4,SC,John Kasich
171,221,235,456,20,R,25,SC,Ted Cruz
172,88,56,144,8,R,6,SC,Ben Carson
173,99,56,155,9,R,6,SC,Jeb Bush
174,276,385,661,25,R,41,SC,Donald Trump
175,1103,940,2043,54,R,46,SC,total
176,409,675,1084,70,D,77,SC,Hillary Clinton
177,175,202,377,30,D,23,SC,Bernie Sanders
178,584,877,1461,40,D,60,SC,total
179,7,14,21,1,R,2,TN,Other/No Answer
180,183,120,303,25,R,17,TN,Marco Rubio
181,51,28,79,7,R,4,TN,John Kasich
182,0,0,0,0,R,0,TN,Uncommitted
183,183,169,352,25,R,24,TN,Ted Cruz
184,44,42,86,6,R,6,TN,Ben Carson
185,7,14,21,1,R,2,TN,Jeb Bush
186,256,316,572,35,R,45,TN,Donald Trump
187,732,703,1435,51,R,49,TN,total
188,346,293,639,64,D,69,TN,Hillary Clinton
189,0,4,4,0,D,1,TN,Uncommitted
190,195,128,323,36,D,30,TN,Bernie Sanders
191,541,425,966,56,D,44,TN,total
192,10,0,10,1,R,0,TX,Other/No Answer
193,230,130,360,22,R,14,TX,Marco Rubio
194,63,18,81,6,R,2,TX,John Kasich
195,0,18,18,0,R,2,TX,Uncommitted
196,428,426,854,41,R,46,TX,Ted Cruz
197,31,46,77,3,R,5,TX,Ben Carson
198,10,18,28,1,R,2,TX,Jeb Bush
199,271,278,549,26,R,30,TX,Donald Trump
200,1044,925,1969,53,R,47,TX,total
201,15,15,30,2,D,2,TX,Other/No Answer
202,491,486,977,65,D,67,TX,Hillary Clinton
203,249,225,474,33,D,31,TX,Bernie Sanders
204,755,726,1481,51,D,49,TX,total
205,6,7,13,2,R,3,VT,Other/No Answer
206,66,37,103,21,R,17,VT,Marco Rubio
207,107,57,164,34,R,26,VT,John Kasich
208,25,26,51,8,R,12,VT,Ted Cruz
209,13,9,22,4,R,4,VT,Ben Carson
210,6,0,6,2,R,0,VT,Jeb Bush
211,92,84,176,29,R,38,VT,Donald Trump
212,316,220,536,59,R,41,VT,total
213,0,4,4,0,D,1,VT,Other/No Answer
214,164,45,209,15,D,10,VT,Hillary Clinton
215,931,398,1329,85,D,89,VT,Bernie Sanders
216,1095,447,1542,71,D,29,VT,total
217,9,6,15,1,R,1,VA,Other/No Answer
218,338,152,490,37,R,25,VA,Marco Rubio
219,119,24,143,13,R,4,VA,John Kasich
220,137,116,253,15,R,19,VA,Ted Cruz
221,55,43,98,6,R,7,VA,Ben Carson
222,9,6,15,1,R,1,VA,Jeb Bush
223,247,262,509,27,R,43,VA,Donald Trump
224,914,609,1523,60,R,40,VA,total
225,0,5,5,0,D,1,VA,Other/No Answer
226,579,321,900,64,D,63,VA,Hillary Clinton
227,325,183,508,36,D,36,VA,Bernie Sanders
228,904,509,1413,64,D,36,VA,total
229,22,16,38,3,R,2,WI,Other/No Answer
230,130,97,227,18,R,12,WI,John Kasich
231,223,309,532,31,R,38,WI,Donald Trump
232,0,0,0,0,R,0,WI,Uninstructed
233,346,390,736,48,R,48,WI,Ted Cruz
234,720,812,1532,47,R,53,WI,total
235,9,0,9,1,D,0,WI,Other/No Answer
236,378,383,761,41,D,45,WI,Hillary Clinton
237,535,469,1004,58,D,55,WI,Bernie Sanders
238,0,0,0,0,D,0,WI,Uninstructed
239,922,852,1774,52,D,48,WI,total
