id,yes:count,no:count,count,yes,party,no,state,name
1,10,0,10,1,R,0,AL,Other/No Answer
2,171,66,237,18,R,23,AL,Marco Rubio
3,29,31,60,3,R,11,AL,John Kasich
4,10,3,13,1,R,1,AL,Uncommitted
5,209,51,260,22,R,18,AL,Ted Cruz
6,105,20,125,11,R,7,AL,Ben Carson
7,10,0,10,1,R,0,AL,Jeb Bush
8,409,117,526,43,R,41,AL,Donald Trump
9,952,285,1237,77,R,23,AL,total
10,11,6,17,1,R,2,AR,Other/No Answer
11,259,91,350,24,R,30,AR,Marco Rubio
12,22,33,55,2,R,11,AR,John Kasich
13,356,55,411,33,R,18,AR,Ted Cruz
14,65,6,71,6,R,2,AR,Ben Carson
15,11,0,11,1,R,0,AR,Jeb Bush
16,356,112,468,33,R,37,AR,Donald Trump
17,1078,304,1382,78,R,22,AR,total
18,18,30,48,2,R,3,FL,Other/No Answer
19,220,288,508,24,R,29,FL,Marco Rubio
20,55,69,124,6,R,7,FL,John Kasich
21,192,129,321,21,R,13,FL,Ted Cruz
22,9,0,9,1,R,0,FL,Ben Carson
23,421,476,897,46,R,48,FL,Donald Trump
24,915,992,1907,48,R,52,FL,total
25,12,0,12,1,R,0,GA,Other/No Answer
26,270,148,418,23,R,28,GA,Marco Rubio
27,47,48,95,4,R,9,GA,John Kasich
28,306,90,396,26,R,17,GA,Ted Cruz
29,71,26,97,6,R,5,GA,Ben Carson
30,12,0,12,1,R,0,GA,Jeb Bush
31,459,216,675,39,R,41,GA,Donald Trump
32,1176,528,1704,69,R,31,GA,total
33,11,7,18,2,R,1,IL,Other/No Answer
34,33,61,94,6,R,9,IL,Marco Rubio
35,105,142,247,19,R,21,IL,John Kasich
36,205,183,388,37,R,27,IL,Ted Cruz
37,6,7,13,1,R,1,IL,Ben Carson
38,194,278,472,35,R,41,IL,Donald Trump
39,555,678,1233,45,R,55,IL,total
40,0,6,6,0,R,1,MI,Other/No Answer
41,65,62,127,9,R,10,MI,Marco Rubio
42,138,185,323,19,R,30,MI,John Kasich
43,14,6,20,2,R,1,MI,Uncommitted
44,232,105,337,32,R,17,MI,Ted Cruz
45,14,12,26,2,R,2,MI,Ben Carson
46,268,241,509,37,R,39,MI,Donald Trump
47,724,617,1341,54,R,46,MI,total
48,11,0,11,1,R,0,MS,Other/No Answer
49,43,23,66,4,R,11,MS,Marco Rubio
50,65,29,94,6,R,14,MS,John Kasich
51,421,49,470,39,R,24,MS,Ted Cruz
52,22,2,24,2,R,1,MS,Ben Carson
53,518,103,621,48,R,50,MS,Donald Trump
54,1079,206,1285,84,R,16,MS,total
55,8,0,8,1,R,0,MO,Other/No Answer
56,33,49,82,4,R,9,MO,Marco Rubio
57,49,87,136,6,R,16,MO,John Kasich
58,0,5,5,0,R,1,MO,Uncommitted
59,425,147,572,52,R,27,MO,Ted Cruz
60,8,5,13,1,R,1,MO,Ben Carson
61,294,251,545,36,R,46,MO,Donald Trump
62,818,545,1363,60,R,40,MO,total
63,77,168,245,30,R,24,NY,John Kasich
64,124,447,571,48,R,64,NY,Donald Trump
65,57,84,141,22,R,12,NY,Ted Cruz
66,258,699,957,27,R,73,NY,total
67,12,17,29,1,R,3,NC,Other/No Answer
68,75,50,125,6,R,9,NC,Marco Rubio
69,0,6,6,0,R,1,NC,No Preference
70,87,140,227,7,R,25,NC,John Kasich
71,559,128,687,45,R,23,NC,Ted Cruz
72,12,6,18,1,R,1,NC,Ben Carson
73,497,212,709,40,R,38,NC,Donald Trump
74,1242,558,1800,69,R,31,NC,total
75,0,12,12,0,R,1,OH,Other/No Answer
76,12,47,59,1,R,4,OH,Marco Rubio
77,496,615,1111,42,R,52,OH,John Kasich
78,236,95,331,20,R,8,OH,Ted Cruz
79,12,0,12,1,R,0,OH,Ben Carson
80,426,414,840,36,R,35,OH,Donald Trump
81,1182,1182,2363,50,R,50,OH,total
82,7,2,9,1,R,1,OK,Other/No Answer
83,183,68,251,26,R,29,OK,Marco Rubio
84,14,19,33,2,R,8,OK,John Kasich
85,275,42,317,39,R,18,OK,Ted Cruz
86,49,7,56,7,R,3,OK,Ben Carson
87,0,2,2,0,R,1,OK,Jeb Bush
88,176,94,270,25,R,40,OK,Donald Trump
89,704,234,938,75,R,25,OK,total
90,0,11,11,0,R,2,SC,Other/No Answer
91,324,126,450,22,R,22,SC,Marco Rubio
92,74,109,183,5,R,19,SC,John Kasich
93,397,74,471,27,R,13,SC,Ted Cruz
94,103,29,132,7,R,5,SC,Ben Carson
95,103,51,154,7,R,9,SC,Jeb Bush
96,485,172,657,33,R,30,SC,Donald Trump
97,1471,572,2043,72,R,28,SC,total
98,22,0,22,2,R,0,TN,Other/No Answer
99,196,103,299,18,R,30,TN,Marco Rubio
100,44,34,78,4,R,10,TN,John Kasich
101,0,0,0,0,R,0,TN,Uncommitted
102,295,62,357,27,R,18,TN,Ted Cruz
103,76,10,86,7,R,3,TN,Ben Carson
104,11,7,18,1,R,2,TN,Jeb Bush
105,447,127,574,41,R,37,TN,Donald Trump
106,1091,344,1435,76,R,24,TN,total
107,12,0,12,1,R,0,TX,Other/No Answer
108,174,182,356,14,R,25,TX,Marco Rubio
109,25,44,69,2,R,6,TX,John Kasich
110,12,7,19,1,R,1,TX,Uncommitted
111,632,226,858,51,R,31,TX,Ted Cruz
112,50,22,72,4,R,3,TX,Ben Carson
113,12,15,27,1,R,2,TX,Jeb Bush
114,322,233,555,26,R,32,TX,Donald Trump
115,1240,729,1969,63,R,37,TX,total
116,0,11,11,0,R,3,VT,Other/No Answer
117,39,64,103,24,R,17,VT,Marco Rubio
118,37,128,165,23,R,34,VT,John Kasich
119,26,26,52,16,R,7,VT,Ted Cruz
120,14,8,22,9,R,2,VT,Ben Carson
121,3,8,11,2,R,2,VT,Jeb Bush
122,42,131,173,26,R,35,VT,Donald Trump
123,161,375,536,30,R,70,VT,total
124,8,7,15,1,R,1,VA,Other/No Answer
125,226,265,491,28,R,37,VA,Marco Rubio
126,48,100,148,6,R,14,VA,John Kasich
127,161,93,254,20,R,13,VA,Ted Cruz
128,65,29,94,8,R,4,VA,Ben Carson
129,8,0,8,1,R,0,VA,Jeb Bush
130,291,222,513,36,R,31,VA,Donald Trump
131,807,716,1523,53,R,47,VA,total
132,6,27,33,1,R,3,WI,Other/No Answer
133,64,160,224,10,R,18,WI,John Kasich
134,219,320,539,34,R,36,WI,Donald Trump
135,0,0,0,0,R,0,WI,Uninstructed
136,354,382,736,55,R,43,WI,Ted Cruz
137,643,889,1532,42,R,58,WI,total
