id,moderate/liberal:count,count,party,conservative:count,moderate/liberal,state,conservative,name
1,0,10,R,10,0,AL,1,Other/No Answer
2,65,229,R,164,24,AL,17,Marco Rubio
3,22,51,R,29,8,AL,3,John Kasich
4,5,15,R,10,2,AL,1,Uncommitted
5,38,260,R,222,14,AL,23,Ted Cruz
6,24,130,R,106,9,AL,11,Ben Carson
7,0,10,R,10,0,AL,1,Jeb Bush
8,117,532,R,415,43,AL,43,Donald Trump
9,272,1237,R,965,22,AL,78,total
10,5,28,R,23,2,AR,2,Other/No Answer
11,72,355,R,283,29,AR,25,Marco Rubio
12,25,59,R,34,10,AR,3,John Kasich
13,40,403,R,363,16,AR,32,Ted Cruz
14,7,64,R,57,3,AR,5,Ben Carson
15,2,2,R,0,1,AR,0,Jeb Bush
16,97,471,R,374,39,AR,33,Donald Trump
17,249,1382,R,1133,18,AR,82,total
18,34,47,R,13,6,FL,1,Other/No Answer
19,160,520,R,360,28,FL,27,Marco Rubio
20,74,127,R,53,13,FL,4,John Kasich
21,69,323,R,254,12,FL,19,Ted Cruz
22,6,19,R,13,1,FL,1,Ben Carson
23,229,870,R,641,40,FL,48,Donald Trump
24,572,1907,R,1335,30,FL,70,total
25,0,13,R,13,0,GA,1,Other/No Answer
26,111,421,R,310,31,GA,23,Marco Rubio
27,39,93,R,54,11,GA,4,John Kasich
28,39,389,R,350,11,GA,26,Ted Cruz
29,21,102,R,81,6,GA,6,Ben Carson
30,0,13,R,13,0,GA,1,Jeb Bush
31,147,672,R,525,41,GA,39,Donald Trump
32,358,1704,R,1346,21,GA,79,total
33,3,12,R,9,1,IL,1,Other/No Answer
34,31,111,R,80,9,IL,9,Marco Rubio
35,117,241,R,124,34,IL,14,John Kasich
36,55,375,R,320,16,IL,36,Ted Cruz
37,3,12,R,9,1,IL,1,Ben Carson
38,135,481,R,346,39,IL,39,Donald Trump
39,345,1233,R,888,28,IL,72,total
40,3,8,R,5,1,MA,1,Other/No Answer
41,46,145,R,99,15,MA,20,Marco Rubio
42,3,3,R,0,1,MA,0,No Preference
43,94,149,R,55,31,MA,11,John Kasich
44,9,74,R,65,3,MA,13,Ted Cruz
45,3,23,R,20,1,MA,4,Ben Carson
46,3,8,R,5,1,MA,1,Jeb Bush
47,143,391,R,248,47,MA,50,Donald Trump
48,304,801,R,497,38,MA,62,total
49,3,13,R,10,1,MI,1,Other/No Answer
50,27,138,R,111,8,MI,11,Marco Rubio
51,114,315,R,201,34,MI,20,John Kasich
52,10,20,R,10,3,MI,1,Uncommitted
53,44,336,R,292,13,MI,29,Ted Cruz
54,7,27,R,20,2,MI,2,Ben Carson
55,131,493,R,362,39,MI,36,Donald Trump
56,335,1341,R,1006,25,MI,75,total
57,0,22,R,22,0,MS,2,Other/No Answer
58,12,66,R,54,6,MS,5,Marco Rubio
59,31,96,R,65,15,MS,6,John Kasich
60,43,475,R,432,21,MS,40,Ted Cruz
61,6,17,R,11,3,MS,1,Ben Carson
62,113,609,R,496,55,MS,46,Donald Trump
63,206,1285,R,1079,16,MS,84,total
64,3,24,R,21,1,MO,2,Other/No Answer
65,27,80,R,53,9,MO,5,Marco Rubio
66,63,137,R,74,21,MO,7,John Kasich
67,3,3,R,0,1,MO,0,Uncommitted
68,72,561,R,489,24,MO,46,Ted Cruz
69,6,17,R,11,2,MO,1,Ben Carson
70,126,541,R,415,42,MO,39,Donald Trump
71,300,1363,R,1063,22,MO,78,total
72,114,243,R,129,41,NY,19,John Kasich
73,131,572,R,441,47,NY,65,Donald Trump
74,36,145,R,109,13,NY,16,Ted Cruz
75,278,957,R,679,29,NY,71,total
76,8,36,R,28,2,NC,2,Other/No Answer
77,34,119,R,85,9,NC,6,Marco Rubio
78,4,4,R,0,1,NC,0,No Preference
79,102,230,R,128,27,NC,9,John Kasich
80,76,673,R,597,20,NC,42,Ted Cruz
81,8,22,R,14,2,NC,1,Ben Carson
82,147,716,R,569,39,NC,40,Donald Trump
83,378,1800,R,1422,21,NC,79,total
84,13,30,R,17,2,OH,1,Other/No Answer
85,26,60,R,34,4,OH,2,Marco Rubio
86,391,1105,R,714,59,OH,42,John Kasich
87,26,315,R,289,4,OH,17,Ted Cruz
88,0,17,R,17,0,OH,1,Ben Carson
89,205,834,R,629,31,OH,37,Donald Trump
90,662,2363,R,1701,28,OH,72,total
91,4,12,R,8,2,OK,1,Other/No Answer
92,53,251,R,198,30,OK,26,Marco Rubio
93,18,33,R,15,10,OK,2,John Kasich
94,30,311,R,281,17,OK,37,Ted Cruz
95,11,57,R,46,6,OK,6,Ben Carson
96,0,8,R,8,0,OK,1,Jeb Bush
97,62,267,R,205,35,OK,27,Donald Trump
98,178,938,R,760,19,OK,81,total
99,4,4,R,0,1,SC,0,Other/No Answer
100,85,449,R,364,22,SC,22,Marco Rubio
101,78,161,R,83,20,SC,5,John Kasich
102,27,457,R,430,7,SC,26,Ted Cruz
103,19,151,R,132,5,SC,8,Ben Carson
104,39,155,R,116,10,SC,7,Jeb Bush
105,136,666,R,530,35,SC,32,Donald Trump
106,388,2043,R,1655,19,SC,81,total
107,3,15,R,12,1,TN,1,Other/No Answer
108,54,301,R,247,21,TN,21,Marco Rubio
109,28,75,R,47,11,TN,4,John Kasich
110,3,3,R,0,1,TN,0,Uncommitted
111,28,358,R,330,11,TN,28,Ted Cruz
112,15,86,R,71,6,TN,6,Ben Carson
113,13,25,R,12,5,TN,1,Jeb Bush
114,114,573,R,459,44,TN,39,Donald Trump
115,258,1435,R,1177,18,TN,82,total
116,4,4,R,0,1,TX,0,Other/No Answer
117,85,360,R,275,24,TX,17,Marco Rubio
118,28,76,R,48,8,TX,3,John Kasich
119,4,20,R,16,1,TX,1,Uncommitted
120,96,855,R,759,27,TX,47,Ted Cruz
121,18,83,R,65,5,TX,4,Ben Carson
122,7,39,R,32,2,TX,2,Jeb Bush
123,113,549,R,436,32,TX,27,Donald Trump
124,354,1969,R,1615,18,TX,82,total
125,5,16,R,11,3,VT,3,Other/No Answer
126,25,104,R,79,14,VT,22,Marco Rubio
127,73,163,R,90,41,VT,25,John Kasich
128,7,50,R,43,4,VT,12,Ted Cruz
129,4,22,R,18,2,VT,5,Ben Carson
130,4,8,R,4,2,VT,1,Jeb Bush
131,60,175,R,115,34,VT,32,Donald Trump
132,177,536,R,359,33,VT,67,total
133,0,11,R,11,0,VA,1,Other/No Answer
134,170,488,R,318,40,VA,29,Marco Rubio
135,89,144,R,55,21,VA,5,John Kasich
136,34,253,R,219,8,VA,20,Ted Cruz
137,26,92,R,66,6,VA,6,Ben Carson
138,9,20,R,11,2,VA,1,Jeb Bush
139,98,515,R,417,23,VA,38,Donald Trump
140,426,1523,R,1097,28,VA,72,total
141,8,31,R,23,2,WI,2,Other/No Answer
142,103,228,R,125,26,WI,11,John Kasich
143,159,533,R,374,40,WI,33,Donald Trump
144,4,4,R,0,1,WI,0,Uninstructed
145,123,735,R,612,31,WI,54,Ted Cruz
146,398,1532,R,1134,26,WI,74,total
